0	0
Сердце в 1000 свечей	10
1000 Hands	1000 HANDS
15 Months	15 MONTHS
19	19 (NINETEEN)
Two Swords (From "Game of Thrones - Season 4")	2 SWORDS
2way traffic	2 WAY TRAFFIC
430	4 MINUS 3 EQUALS ZERO
7 Rings	7 RINGS (WORKOUT REMIX 135 BPM)
A Cottage for Sale	A COTTAGE FOR SALE
A Little Respect	A LITTLE RESPECT
A Short History Lesson	A SHORT HISTORY LESSON
ABC Rap	ABC RAP
Aciona	ACIONA
Affirmation	AFFIRMATION
Aggro Medley (Sound by the Pound / Let's Pack Our Bags / Reggae Hit L.A.) [Live]	AGRO MEDLEY
Akhian	AKHIAN (FUNKADELIK REMIX)
Alarm	ALARM
All For You	ALL FOR YOU
All I Need	ALL I NEED
Alone	ALL ONE
Altered Beast	ALTERED BEAST
Anahata Sleep Music	ANAHATA SLEEP MUSIC
And Then She Stopped	AND THEN SHE STOPS
Another Used To Be	ANOTHER USED TO BE
Answer Me, My Love	ANSWER ME MY LOVE
Apollo 4	APOLLO 4 (RSM 071)
Apple Tree	APPLE TREE
Arcarsenal	ARCARSENAL
Armed & Dangerous	ARMED AND DANGEROUS
Ave Maria, D. 839, Op. 52, No. 6 (Ellens Gesang III from "Ein Fräulein vom See") [Arr. for Cello and Piano]	AVE MARIA, D. 839, OP. 52, NO. 6
Avião de Papel	AVIAO DE PAPEL
Baby Food	BABYFOOD
Bad Food	BAD FOOD
Badass - Original Mix	BADASS ORIGINAL MIX
Bass City Roller	BASS CITY ROLLER
Bellinzona (Live)	BELLINZONA
Better Day	BETTER DAYS
Better Half (feat. Recess)	BETTER HALF
Bhangra Punjabiyan Ne	BHANGRA PUNJABIYAN NE
Big World	BIG WORLD
Bilmem Nedeyim	BILMEM NE DEYIM
Black And Yellow (2015 Running Mix)	BLACK AND YELLOW
Black Ipa	BLACK IPA
Black Leather	BLACK LEATHER
Black Snow	BLACK SNOW
Blizzard	BLIZZARD   (FR FILM"GROUNDHOG DAY")
Blue	BLUES (MY NAUGHTY SWEETIE GIVES TO ME)
The Bogeyman	BOGEYMAN (POP@PS-047)
Bonnie Wee Thing	BONNIE WEE THING
Borro Cassette	BORRO CASSETTE
Bound for South Australia	BOUND FOR SOUTH AUSTRALIA
Boxed Off	BOXED OFF
A Brand New Day	BRAND NEW DAY
Bridges	BRIDGES (IN HOLLAND)
Brown Little Bird	BROWN LITTLE BIRD
Built to Break	BUILT TO BREAK
Bullet	BULLET THE BLUE SKY
Calcutta Kiss	CALCUTTA KISS
Calm Dog Songs	CALM DOG SONGS
Can You Run	CAN YOU RUN
Candy - Original Mix	CANDY ORIGINAL MIX
Cantaloupe Woman - Remastered	CANTELOUPE WOMEN
La Canzone	CANZONE
Capriccio brillant in B Minor, Op. 22, MWV O 8	CAPRICCIO BRILLANT IN B MINOR, OP. 22
Castingallee	CASTINGALLEE
Ceylon	CEYLON
Cha Cha Cha (feat. Busta Rhymes, Baby Sham, Rah Digga & Spliff Star)	CHA CHA CHA
Champion Of Love	CHAMPIONS OF LOVE
Chanter	CHANTER
Cheer	CHEERS
Chieu Mot Minh Qua Pho	CHIEU MOT MINH QUA PHO
Children Of The Night	CHILDREN OF NIGHT
Chuyen Tinh Khong Di Vang	CHUYEN TINH KHONG DI VANG
Cigbox Adlib	CIGBOX ADLIB
citanLu	CITANLU
Civil War	CIVIL WAR
Cliff Dwelling	CLIFF DWELLING
Cocaine Blues	COCAINE BLUES
Cold December	COLD DECEMBER
Come Rain or Shine	COME RAIN OR SHINE
Come Running	COME RUNNING
Comin at You	COMING AT YA
Concerto In D Major: II. Larghetto	CONCERTO IN D MAJOR II LARGHETTO
Concerto Movement in C Major for Violin and Chamber Orchestra - Fragment completed by Wilfried Fischer: Allegro con brio	CONCERTO MOVEMENT IN C MAJOR FOR VIOLIN AND CHAMBER ORCHESTR
Concordia Military Club	CONCORDIA MILITARY CLUB
Consolacao	CONSOLACAO
Constancia	CONSTANCIA
Constant Waterfall	CONSTANT WATERFALL
Copy Mi Donkey	COPY MI DONKEY
Could You Be Loved	COULD YOU BE LOVED
Creep	CREEP (ACOUSTIC)
A Cruel Madness	CRUEL MADNESS
Cry to Me	CRY TO ME
La cumparsita	CUMPARSITA
Da Doo Ron Ron	DA DOO RON RON
Dagistan	DAGISTAN
Darlin'	DARLIN
David Melrose - Piano Virtuoso	DAVID MELROSE - PIANO VIRTUOSO
De Olvidarla Me Olvide	DE OLVIDARLA ME OLVIDE
Deep Enlightenment	DEEP ENLIGHTENMENT
Desihra Mogontiacum	DESIHRA MOGONTIACUM
Dia Da Moka	DIA DA MOKA
Dia De Folga	DIA DE FOLGA
Diamonds	DIAMONDS
Diaraby Magni	DIARABY MAGNI
Didgeridildo	DIDGERIDILDO
Die Zauberflöte, K. 620: Act II: Dialog - Morden soll ich?	DIE ZAUBERFLOTE K620 ACT II DIE STRAHLEN DER SONNE
Dizziness	DIZZINESS
Do You Know Me	DO YA KNOW ME
Don't Let Her Be Gone	DON'T LET HER BE GONE
Don't Hold Back	DONT HOLD BACK (YOUR LOVE)
Down, Down, Down	DOWN DOWN DOWN
DOWN TO THE BONE	DOWN TO BONE
Dream Bar	DREAM BAR
Dumb Dumb	DUMB DUMB
Earthshine	EARTHSHINE
Eilat	EILAT
El Café De Chinitas	EL CAFE DE CHINITAS
El Hawa Hawaya	EL HAWA HAWAYA
El Mayo Zambada	EL MAYO ZAMBADA
The People United Will Never Be Defeated! - 36 Variations on ¡El pueblo unido jamás será vencido!: Var. 25	EL PUEBLO UNIDO JAMAS SERA VENCIDO
Enchantment	ENCHANTMENT
Enemy Solo (feat. P Square)	ENEMI SOLO
Etude 5	ETUDES FOR PIANO
Euge coeli porta	EUGE COELI PORTA
Every Heartbeat	EVERY HEARTBEAT
Exotic Chinese Massage - Comforting, Relaxing, Massage, Zen Music, Yoga	EXOTIC CHINESE MASSAGE - COMFORTING, RELAXING, MASSAGE, ZEN
Fa Sho	FA SHO
Fade	FADE
Fandango	FANDANGO
Fantasia veneziana	FANTASIA VENEZIANA
Fast And Furious	FAST AND FURIOUS
Feels Like (Everything's Alright)	FEEL S LIKE
Feeling Hot (Karaoke Version) [In the Style of Don Omar]	FEELING HOT
Felefeber	FELEFEBER
Filaraki Ap' To Lykeio	FILARAKI AP' TO LYKEIO
Firefly (with Count Basie & His Orchestra)	FIREFLY (YT@023)
Flatrate Stress	FLATRATE STRESS
Forever (Escort Remix Instrumental)	FOREVER
Forza spirituale	FORZA SPIRITUALE
Free Your Mind	FREE YOUR MIND
Fujisan	FUJI SAN
Funk Hunter	FUNK HUNTER
Funky Music	FUNKY MUSIC
Funky Rhythm	FUNKY RHYTHM
Gamma	GAMMA
Gave You Time	GAVE YOU TIME
Gel Esmerim	GEL ESMERIM
Georgia Rhythm	GEORGIA RHYTHM
Georgie	GEORGIE
Global	GLOBAL
God I'll Live	GOD I'LL LIVE
Bonus Track	GOD REST YE MERRY GENTLEMEN
Golden Girls	GOLDEN GIRLS
A Good Feeling (feat. Syd Bennet)	GOOD FEELING
Good Time Coming	GOOD TIMES COMING/FEEL THE SUN
Goomba Boomba	GOOMBA BOOMBA
Got To Get	GOT TO GET
green something palace	GREEN SOMETHING PALACE
Greensleeves	GREENSLEEVES
Grumpy Cat	GRUMPY CAT
Gully 2	GULLY 2
Hai visto mai	HAI VISTO MAI
Half Moon	HALF MOON
Hallucinations	HALLUCINATIONS
Happy House	HAPPY HOUSE
Happy Little Children Playing on the Cherry Tree	HAPPY LITTLE CHILDREN PLAYING ON THE CHERRY TREE
Hassa Beek	HASSA BEEK
Heartland Express	HEARTLAND EXPRESS
The Hell	HELL
Hello	HELLO
Hemingway's Shotgun	HEMINGWAY S SHOTGUN
Home Guard Blues	HOME GUARD BLUES
Hometown Glory	HOMETOWN GLORY
Homicide	HOMICIDE
Homicide	HOMICIDE
Hood Politics	HOOD POLITICS
How Long Blues	HOW LONG HOW LONG BLUES (VERSION 2)
I Can Dream	I CAN DREAM
I Cried	I CRIED
I pray for you - Aoi Kiseki -	I PRAY FOR YOU - AOI KISEKI -
I Should Be...	I SHOULD BE
I Think About You	I THINK ABOUT YOU
I Want Your Soul	I WANT YOUR SOUL
I'm Coming Home	I'M COMING HOME
If You Go Away	IF YOU GO AWAY
In Silence	IN SILENCE
Incompatible	INCOMPATIBLE
Inevitable	INEVITABLE
Inner Peace - Mindfulness Training	INNER PEACE - MINDFULNESS TRAINING
intro	INTRO
Intro	INTRO
Invaders	INVADERS
Island Breeze	ISLAND BREEZE
Isolation	ISOLATION
Just Another Groove (Tocadisco Remix)	IT'S JUST ANOTHER GROOVE
Itshe	IT'S SHE
It's You	IT'S YOU
Jamal Hit 1k	JAMAL HIT 1K
Japan	JAPAN
Jazz Expression	JAZZ EXPRESSION
Jazzy Sonnet	JAZZY SONNET
Joy To The World	JOY TO WORLD
Just Dance	JUST DANCE
Just that little thing	JUST THAT LITTLE THING
Kaotica	KAOTICA
Karine	KARINE
Saka	KATUVU
Keep I Rolling	KEEP I ROLLING
Kenji	KENJI
Kerosene	KEROSENE
Keyhole	KEYHOLE
Kheet Daa'eef	KHEET DAA'EEF
Kondor	KONDOR
La Catedral - Allegro	LA CATEDRAL - ALLEGRO
La vida mata	LA VIDA MATA
Lack of Existence	LACK OF EXISTENCE
Lacrimile Mele	LACRIMILE MELE
Last To Know	LAST TO KNOW
Late Summer, Early Autumn	LATE SUMMER EARLY AUTUMN
Leavin' Blues	LEAVIN BLUES
Cabinet	LES CABINETS
Let It Go	LET IT GO (ACOUSTIC)
Let Me Die	LET ME DIE
Let Me Heal	LET ME HEAL
Let's Dance	LET'S DANCE
Lgm. Rangkaian Melati	LGM. RANGKAIAN MELATI
Lifted	LIFTED (KPMTK 12)
Lilith	LILITH
Links	LINK
Lipstick	LIPSTICK(EXTREME@XCD418)
Little Little Little	LITTLE LITTLE
Livin' On a Prayer (In the Style of Bon Jovi) [Karaoke Version]	LIVING ON PRAYER
Lonesome Man	LONESOME MAN
Long Past Settled In (Live)	LONG PAST SETTLED IN
Looking For	LOOKING FOR
Louder	LOUDER
Love Don't Come Easy	LOVE DONT COME EASY
Love Hate Kinda Thing	LOVE HATE KINDA THING
Love Is	LOVE IS
I've Been Loving You Too Long	LOVING YOU
Low Down Dirty Dog Blues	LOW DOWN DIRTY DOG BLUES
Lunar	LUNAR
Lush Life	LUSHLIFE
Lyrical Hypnosis	LYRICAL HYPNOSIS
Make U Mine	MAKE U MINE
Mamacita Buena - Extended	MAMACITA BUENA EXTENDED
Maneater	MANEATERS
Manon	MANON
Marchand de sable	MARCHAND DE SABLE
Margie	MARGIE
Mary Had a Little Lamb	MARY HAD LITTLE LAMB
La mauvaise réputation	MAUVAISE REPUTATION
Max	MAXX
Meet Me in N.Y.	MEET ME IN N.Y.
Mekka	MEKKA
Mela	MELA
Missed the Point	MISSED POINT
Mission Imposible	MISSION IMPOSSIBLE
Moderation	MODERATION
Molasses	MOLASSES
Monumental Fool	MONUMENTAL FOOL
Moon River	MOON RIVER
Morceaux de salon, Op. 10: VII. Mazurka in D-Flat Major	MORCEAUX DE SALON, OP. 10: VII. MAZURKA
Mother Can You See Me	MOTHER CAN YOU SEE ME
A Mother's Love	MOTHER S LOVE
Unplugged - Remastered	MTV UNPLUGGED (THEME)
Muleskinner Blues (Blue Yodel #8)	MULE SKINNER BLUES
Music	MUSIC
Music for Concentration	MUSIC FOR CONCENTRATION (BRAIN WAVES & SEA WAVES)
My Dear Princess	MY DEAR PRINCESS
My Imagination	MY IMAGINATION
My Life Story	MY LIFE STORY
N M E	N M E
Dem Niggas	N.I.G.G.A.
Nach Acht	NACH ACHT
Nameless	NAMELESS
Natural Sleep Aid	NATURAL SLEEP AID
Ne Mogu Disat	NE MOGU DISAT
Never Hold Me Down	NEVER HOLD ME DOWN
Never Let Go	NEVER LET GO
Why Bother	NEW ADVENTURES OF FLIPPER (SERIES 3 & 4)
Newborn Sleep Music Lullabies	NEWBORN SLEEP MUSIC LULLABIES
Nginikela Kuwe	NGINIKELA KUWE
Night To Day	NIGHT TO DAY
Nihil Sleighride	NIHIL SLEIGHRIDE
No Aguanto Más	NO AGUANTO MAS
No Image	NO IMAGES
O Amor Se Intrometeu	O AMOR SE INTROMETEU
O Little Town of Bethlehem	O LITTLE TOWN OF BETHLEHEM
Oye	OH YES (FREEDOM)
Oh, My Days	OH! MY DAYS
On Now	ON NOW
On a Safari	ON SAFARI
One Day My Soul Opened Up	ONE DAY MY SOUL OPENED UP
One for Me	ONE FOR ME
One Way Street	ONE WAY STREET
Onions	ONION
Oof	OOF
Order Up	ORDER UP (FEAT. SMUG THUGZ)
Our Heroes	OUR HEROES
Over Now	OVER NOW
P$A	PAA
Pag Ghungaroo Bandh Meera	PAG GHUNGAROO BANDH MEERA
Panama 500	PANAMA 500
Papa Loved Mama	PAPA LOVED MAMA (ORIGINALLY PERFORMED BY GARTH BROOKS) KARAO
Part of Your World	PART OF YOUR WORLD (LITTLE MERMAID)
Rap o Clap'o	PARTY TO THE BEAT
Pasito Tun, Tun	PASITO TUN TUN
พลัดพราก	พลัดพราก
Буду с тобой - Акустическая версия	БУДУ С ТОБОЙ - АКУСТИЧЕСКАЯ ВЕРСИЯ
馬戲團公約	馬戲團公約
سوبر مان	سوبر مان
으쌰! 으쌰!	으쌰! 으쌰!
姑娘生来爱歌歌唱	姑娘生来爱唱歌
奮不顧身	奮不顧身
Провинциальный (джаз-бэнд)	ПРОВИНЦИАЛЬНЫЙ ДЖАЗ-БЭНД
誰留下眼淚	誰留下眼淚
你決定就好	你決定就好
遙遠的她 (國)	遙遠的她 (國)
Лысая девочк	ЛЫСАЯ ДЕВОЧКА
คนที่ถูกลืม	คนที่ถูกลืม
黒い雫	黒い雫
Танцевать	ТАНЦЕВАТЬ
卡布奇诺	卡布奇诺
Тільки ти і я	ТІЛЬКИ ТИ І Я
Patterns (Manos Milonakis Rework)	PATTERN
Peace for My World	PEACE FOR MY WORLD (REPRISE)
Peau de Chagrin - Bleu de nuit	PEAU DE CHAGRIN - BLEU DE NUIT
Peer Gynt Suite No. 1: The Death Of Ase	PEER GYNT SUITE NO. 1 - DEATH OF ASE
Perdido	PERDIDO
Piano Dreams	PIANO DREAMS
Piano Sonata No. 16 in G Major, Op. 31 No. 1: II. Adagio grazioso	PIANO SONATA NO. 16 IN G MAJOR, OP. 31, NO. 1: I. ALLEGRO VI
Pick Your Position	PICK YOUR POSITION (LP VERSION)
Pirata del estrecho	PIRATAS DEL ESTRECHO
Pitta Patta	PITTA PATTA
Piwko	PIWKO
Pokemon Advanced Battle	POKEMON ADVANCED BATTLE
Popular	POPULAR
Power - Original Mix	POWER - ORIGINAL MIX
Premonition Of Circular Clouds	PREMONITION OF CIRCULAR CLOUDS
Pretenciosa	PRETENCIOSA
Pretty Penny	PRETTY PENNY
Pua Lililehua	PUA LILILEHUA
Pussy Footin'	PUSSY FOOTIN'
Puzzle Piece	PUZZLE PIECES
Que Pasara	QUE PASARA
The Rat Eaters	RAT EATER
Ready To Rip	READY TO RIP
Real Talk	REAL TALK
Reflexology in Japanese Garden	REFLEXOLOGY IN JAPANESE GARDEN
Reggae Reggae	REGGAE REGGAE
REGRET	REGRETS
Remember Me (Made Famous by T.I.)	REMEMBER ME (BEATSOLE REMIX)
Reprise (If I Can't Change Your Heart)	REPRISE
Retreat	RETREAT
Rich Scrag	RICH SCRAG
Rise	RISE
Romance de Lanzarote	ROMANCE DE LANZAROTE
Rough and Rugged - Remastered	ROUGH AND RUGGED
Rowboat	ROW BOAT
Rózsikám jöjj vissza	ROZSIKAM JOJJ VISSZA
Samba Dobrado	SAMBA DOBRADO
Saving Caroline	SAVING CAROLINE
Se o Mundo Inteiro Pudesse Me Ouvir	SE O MUNDO INTEIRO PUDESSE ME OUVIR
Seehunger Love	SEEHUNGER LOVE
Selina (Ethiopian Eritrean Contemporary)	SELINA
Send Me An Angel (1983 Remix) (Re-Recorded / Remastered)	SEND ME AN ANGEL
Seven Words (Crystal Lake Edit)	SEVEN WORDS
Sevenden Adam Olmaz	SEVENDEN ADAM OLMAZ
Shake Your Tail Feather	SHAKE A TAIL FEATHER
Shepherd's Hey	SHEPHERD'S HEY
Shine	SHINE (12)
Shoeshine Man	SHOESHINE MAN
Shot Me Down	SHOT ME DOWN   (BANG BANG)
Shy	SHY
Side to Side	SIDE TO SIDE
Sistema Solar	SISTEMA SOLAR
Skatanic	SKATANIC
-SKIT-	SKIT
Sleep Well	SLEEP WELL
Slow Down (feat. Julius Caeser)	SLOW DOWN
So Sorry !	SO SORRY
Soft Water	SOFT WATER
Soft, Smooth, and Sensual	SOFT, SMOOTH, AND SENSUAL
Soldier	SOLDIER
Solenzara	SOLENZARA
Something	SOME THINGS
Something	SOME THINGS
Somebody Told Me	SOMEBODY TOLD ME
Son Nefesim	SON NEFESIM (AKUSTIK)
Soothing Music	SOOTHING MUSIC
Spam Sucker	SPAM SUCKER
Speedway	SPEEDWAY
Spreadin' rhythm around	SPREADING RHYTHM AROUND
Stars	STARE
Still Ignorant	STILL IGNORANT
Stop	STOP
Stop Trying To Be God	STOP TRYING TO BE GOD
String Quartet No.13 In G Major, Op.106, B. 192: 1. Allegro moderato	STRING QUARTET NO. 13 IN G MAJOR, OP. 106: I. ALLEGRO MODERA
Strip Club	STRIPCLUB
Stuck On You	STUCK ON YOU
Sunshine	SUNSHINE
Surfing the Waves	SURFING WAVE
Surroundings	SURROUNDING
Sweet Swing	SWEET SWING
Symphony No. 4 In E Minor, Op. 98: Andante Moderato	SYMPHONY NO. 4 IN E MINOR OP. 98: ANDANT (PC@DVD1      0)
Ta Oria	TA ORIA
Tai Chi Music	TAI CHI MUSIC
Take It Home	TAKE IT HOME
Take Me to Church	TAKE ME TO CHURCH
Taken Liberty	TAKEN' LIBERTY
Tantalus	TANTALUS
Tapsilogue	TAPSILOGUE
Tashi Choeten (Sound Track)	TASHI CHOETEN (SOUND TRACK)
Telecommunication	TELECOMMUNICATION (COSMOS 375.229)
Temple on Green Mountain	TEMPLE ON GREEN MOUNTAIN
That Name	THAT NAME
The Eleventh Hour	THE ELEVENTH HOUR
Invasion	THE INVASION (FROM "1941)
The Life That We Dream Of (Original Mix)	THE LIFE THAT WE DREAM OF
Simple Thing	THE SIMPLE THINGS
늪지대 Swamp	THE SWAMP
The Trial And The Grave	THE TRIAL AND GRAVE
These Hands	THESE HANDS
Recover	THIRD TIME LUCKY
Throwing Your Voice	THROWING YOUR VOICE
Ti Ironia	TI IRONIA
Tightrope	TIGHTROPE
Till Then	TILL THEN (TIME STANDS STILL)
Time Spent	TIME SPENT
Tondero (Canto Popular Flamenco) - Remastered	TONDERO
Tori Day	TORI DAY
Trav'lin' Light	TRAV'LIN' LIGHT
The Traveller	TRAVELLER
Triad (The Saw Is Family)	TRIAD
Trick Daisy	TRICK DAISY
Trinkle, Tinkle	TRINKLE TINKLE
Tristan und Isolde / Act 2: "Isolde! Geliebte! - Tristan! Geliebter!"	TRISTAN UND ISOLDE, ACT 2: "ISOLDE GELIEBTE! ... TRISTAN GEL
Turbine	TURBINE
Twenty-Three Lubed Up Schizophrenics With Delusions Of Grandeur	TWENTY THREE LUBED UP SCHIZOPHRENICS WITH DELUSION
Upper Peninsula (feat. Terekke)	UPPER PENINSULA
Ursonate 3	URSONATE 3
Vajra	VAJRA
Veni, Sancte Spiritus	VENI SANCTE SPIRITUS
Vibe	VIBES
Virginie	VIRGINIE
Vivian	VIVIAN
Voici L'été	VOICI L'ETE (HIER KOM DIE SOMER) (ZA)
W / Brasil (Chama o síndico)	W/BRASIL
Waka	WAKA
Wake Me Up	WAKE ME UP
Waltz No. 2 in A-Flat Major, Op. 34 No. 1 - "Valse brillante"	WALTZ: NO. 2 IN A FLAT MAJOR, OP. 34 NO. 1
War	WAR!
Warm Air	WARMAIRE
Weather Change	WEATHER CHANGE
Welcome to Trollstad	WELCOME TO TROLLSTAD
Well Tempered Clavichord, Book 1: Prelude in C	WELL TEMPERED CLAVICHORD, BOOK 1: PRELUDE IN C
Wendy Clear	WENDY CLEAR
Wet Wet	WET WET IN DUB
Whale Song	WHALE SONG
What I'm Looking For	WHAT I'M LOOKIN' FOR
Lo' Borrachos	WHAT WENT DOWN
When We First Kissed	WHEN WE FIRST KISSED
Where Are You	WHEREAREYOU (LIVE)
Where Would I Be (feat. Omar Terzic)	WHEREWOULDIBE
Whirlwind	WHIRLWIND
Whirlwind (feat. Ohene Savant)	WHIRLWIND
(W)hole	WHOLE
Wild Dreams	WILD DREAMS (JELLY BEANS)
Will She Just Fall Down	WILL SHE JUST FALL DOWN?
Wind	WIND
The Witch	WITCH
Yáll Don't Want War	Y'ALL DON'T WANT WAR
Yasisi (inst)	YA SI SI
Yellow	YELLOW (ACOUSTIC)
Yellowcake UF6	YELLOWCAKE UF6
You Showed Me	YOU SHOWED ME
Zion Poison	ZION POISON